[console_scripts]
neutron = neutronclient.shell:main

[neutron.cli.v2]
address-scope-create = neutronclient.neutron.v2_0.address_scope:CreateAddressScope
address-scope-delete = neutronclient.neutron.v2_0.address_scope:DeleteAddressScope
address-scope-list = neutronclient.neutron.v2_0.address_scope:ListAddressScope
address-scope-show = neutronclient.neutron.v2_0.address_scope:ShowAddressScope
address-scope-update = neutronclient.neutron.v2_0.address_scope:UpdateAddressScope
agent-delete = neutronclient.neutron.v2_0.agent:DeleteAgent
agent-list = neutronclient.neutron.v2_0.agent:ListAgent
agent-show = neutronclient.neutron.v2_0.agent:ShowAgent
agent-update = neutronclient.neutron.v2_0.agent:UpdateAgent
auto-allocated-topology-delete = neutronclient.neutron.v2_0.auto_allocated_topology:DeleteAutoAllocatedTopology
auto-allocated-topology-show = neutronclient.neutron.v2_0.auto_allocated_topology:ShowAutoAllocatedTopology
availability-zone-list = neutronclient.neutron.v2_0.availability_zone:ListAvailabilityZone
bash-completion = neutronclient.shell:BashCompletionCommand
bgp-dragent-list-hosting-speaker = neutronclient.neutron.v2_0.bgp.dragentscheduler:ListDRAgentsHostingBGPSpeaker
bgp-dragent-speaker-add = neutronclient.neutron.v2_0.bgp.dragentscheduler:AddBGPSpeakerToDRAgent
bgp-dragent-speaker-remove = neutronclient.neutron.v2_0.bgp.dragentscheduler:RemoveBGPSpeakerFromDRAgent
bgp-peer-create = neutronclient.neutron.v2_0.bgp.peer:CreatePeer
bgp-peer-delete = neutronclient.neutron.v2_0.bgp.peer:DeletePeer
bgp-peer-list = neutronclient.neutron.v2_0.bgp.peer:ListPeers
bgp-peer-show = neutronclient.neutron.v2_0.bgp.peer:ShowPeer
bgp-peer-update = neutronclient.neutron.v2_0.bgp.peer:UpdatePeer
bgp-speaker-advertiseroute-list = neutronclient.neutron.v2_0.bgp.speaker:ListRoutesAdvertisedBySpeaker
bgp-speaker-create = neutronclient.neutron.v2_0.bgp.speaker:CreateSpeaker
bgp-speaker-delete = neutronclient.neutron.v2_0.bgp.speaker:DeleteSpeaker
bgp-speaker-list = neutronclient.neutron.v2_0.bgp.speaker:ListSpeakers
bgp-speaker-list-on-dragent = neutronclient.neutron.v2_0.bgp.dragentscheduler:ListBGPSpeakersOnDRAgent
bgp-speaker-network-add = neutronclient.neutron.v2_0.bgp.speaker:AddNetworkToSpeaker
bgp-speaker-network-remove = neutronclient.neutron.v2_0.bgp.speaker:RemoveNetworkFromSpeaker
bgp-speaker-peer-add = neutronclient.neutron.v2_0.bgp.speaker:AddPeerToSpeaker
bgp-speaker-peer-remove = neutronclient.neutron.v2_0.bgp.speaker:RemovePeerFromSpeaker
bgp-speaker-show = neutronclient.neutron.v2_0.bgp.speaker:ShowSpeaker
bgp-speaker-update = neutronclient.neutron.v2_0.bgp.speaker:UpdateSpeaker
dhcp-agent-list-hosting-net = neutronclient.neutron.v2_0.agentscheduler:ListDhcpAgentsHostingNetwork
dhcp-agent-network-add = neutronclient.neutron.v2_0.agentscheduler:AddNetworkToDhcpAgent
dhcp-agent-network-remove = neutronclient.neutron.v2_0.agentscheduler:RemoveNetworkFromDhcpAgent
ext-list = neutronclient.neutron.v2_0.extension:ListExt
ext-show = neutronclient.neutron.v2_0.extension:ShowExt
firewall-create = neutronclient.neutron.v2_0.fw.firewall:CreateFirewall
firewall-delete = neutronclient.neutron.v2_0.fw.firewall:DeleteFirewall
firewall-list = neutronclient.neutron.v2_0.fw.firewall:ListFirewall
firewall-policy-create = neutronclient.neutron.v2_0.fw.firewallpolicy:CreateFirewallPolicy
firewall-policy-delete = neutronclient.neutron.v2_0.fw.firewallpolicy:DeleteFirewallPolicy
firewall-policy-insert-rule = neutronclient.neutron.v2_0.fw.firewallpolicy:FirewallPolicyInsertRule
firewall-policy-list = neutronclient.neutron.v2_0.fw.firewallpolicy:ListFirewallPolicy
firewall-policy-remove-rule = neutronclient.neutron.v2_0.fw.firewallpolicy:FirewallPolicyRemoveRule
firewall-policy-show = neutronclient.neutron.v2_0.fw.firewallpolicy:ShowFirewallPolicy
firewall-policy-update = neutronclient.neutron.v2_0.fw.firewallpolicy:UpdateFirewallPolicy
firewall-rule-create = neutronclient.neutron.v2_0.fw.firewallrule:CreateFirewallRule
firewall-rule-delete = neutronclient.neutron.v2_0.fw.firewallrule:DeleteFirewallRule
firewall-rule-list = neutronclient.neutron.v2_0.fw.firewallrule:ListFirewallRule
firewall-rule-show = neutronclient.neutron.v2_0.fw.firewallrule:ShowFirewallRule
firewall-rule-update = neutronclient.neutron.v2_0.fw.firewallrule:UpdateFirewallRule
firewall-show = neutronclient.neutron.v2_0.fw.firewall:ShowFirewall
firewall-update = neutronclient.neutron.v2_0.fw.firewall:UpdateFirewall
flavor-associate = neutronclient.neutron.v2_0.flavor.flavor:AssociateFlavor
flavor-create = neutronclient.neutron.v2_0.flavor.flavor:CreateFlavor
flavor-delete = neutronclient.neutron.v2_0.flavor.flavor:DeleteFlavor
flavor-disassociate = neutronclient.neutron.v2_0.flavor.flavor:DisassociateFlavor
flavor-list = neutronclient.neutron.v2_0.flavor.flavor:ListFlavor
flavor-profile-create = neutronclient.neutron.v2_0.flavor.flavor_profile:CreateFlavorProfile
flavor-profile-delete = neutronclient.neutron.v2_0.flavor.flavor_profile:DeleteFlavorProfile
flavor-profile-list = neutronclient.neutron.v2_0.flavor.flavor_profile:ListFlavorProfile
flavor-profile-show = neutronclient.neutron.v2_0.flavor.flavor_profile:ShowFlavorProfile
flavor-profile-update = neutronclient.neutron.v2_0.flavor.flavor_profile:UpdateFlavorProfile
flavor-show = neutronclient.neutron.v2_0.flavor.flavor:ShowFlavor
flavor-update = neutronclient.neutron.v2_0.flavor.flavor:UpdateFlavor
floatingip-associate = neutronclient.neutron.v2_0.floatingip:AssociateFloatingIP
floatingip-create = neutronclient.neutron.v2_0.floatingip:CreateFloatingIP
floatingip-delete = neutronclient.neutron.v2_0.floatingip:DeleteFloatingIP
floatingip-disassociate = neutronclient.neutron.v2_0.floatingip:DisassociateFloatingIP
floatingip-list = neutronclient.neutron.v2_0.floatingip:ListFloatingIP
floatingip-show = neutronclient.neutron.v2_0.floatingip:ShowFloatingIP
ipsec-site-connection-create = neutronclient.neutron.v2_0.vpn.ipsec_site_connection:CreateIPsecSiteConnection
ipsec-site-connection-delete = neutronclient.neutron.v2_0.vpn.ipsec_site_connection:DeleteIPsecSiteConnection
ipsec-site-connection-list = neutronclient.neutron.v2_0.vpn.ipsec_site_connection:ListIPsecSiteConnection
ipsec-site-connection-show = neutronclient.neutron.v2_0.vpn.ipsec_site_connection:ShowIPsecSiteConnection
ipsec-site-connection-update = neutronclient.neutron.v2_0.vpn.ipsec_site_connection:UpdateIPsecSiteConnection
l3-agent-list-hosting-router = neutronclient.neutron.v2_0.agentscheduler:ListL3AgentsHostingRouter
l3-agent-router-add = neutronclient.neutron.v2_0.agentscheduler:AddRouterToL3Agent
l3-agent-router-remove = neutronclient.neutron.v2_0.agentscheduler:RemoveRouterFromL3Agent
lb-agent-hosting-pool = neutronclient.neutron.v2_0.agentscheduler:GetLbaasAgentHostingPool
lb-healthmonitor-associate = neutronclient.neutron.v2_0.lb.healthmonitor:AssociateHealthMonitor
lb-healthmonitor-create = neutronclient.neutron.v2_0.lb.healthmonitor:CreateHealthMonitor
lb-healthmonitor-delete = neutronclient.neutron.v2_0.lb.healthmonitor:DeleteHealthMonitor
lb-healthmonitor-disassociate = neutronclient.neutron.v2_0.lb.healthmonitor:DisassociateHealthMonitor
lb-healthmonitor-list = neutronclient.neutron.v2_0.lb.healthmonitor:ListHealthMonitor
lb-healthmonitor-show = neutronclient.neutron.v2_0.lb.healthmonitor:ShowHealthMonitor
lb-healthmonitor-update = neutronclient.neutron.v2_0.lb.healthmonitor:UpdateHealthMonitor
lb-member-create = neutronclient.neutron.v2_0.lb.member:CreateMember
lb-member-delete = neutronclient.neutron.v2_0.lb.member:DeleteMember
lb-member-list = neutronclient.neutron.v2_0.lb.member:ListMember
lb-member-show = neutronclient.neutron.v2_0.lb.member:ShowMember
lb-member-update = neutronclient.neutron.v2_0.lb.member:UpdateMember
lb-pool-create = neutronclient.neutron.v2_0.lb.pool:CreatePool
lb-pool-delete = neutronclient.neutron.v2_0.lb.pool:DeletePool
lb-pool-list = neutronclient.neutron.v2_0.lb.pool:ListPool
lb-pool-list-on-agent = neutronclient.neutron.v2_0.agentscheduler:ListPoolsOnLbaasAgent
lb-pool-show = neutronclient.neutron.v2_0.lb.pool:ShowPool
lb-pool-stats = neutronclient.neutron.v2_0.lb.pool:RetrievePoolStats
lb-pool-update = neutronclient.neutron.v2_0.lb.pool:UpdatePool
lb-vip-create = neutronclient.neutron.v2_0.lb.vip:CreateVip
lb-vip-delete = neutronclient.neutron.v2_0.lb.vip:DeleteVip
lb-vip-list = neutronclient.neutron.v2_0.lb.vip:ListVip
lb-vip-show = neutronclient.neutron.v2_0.lb.vip:ShowVip
lb-vip-update = neutronclient.neutron.v2_0.lb.vip:UpdateVip
lbaas-agent-hosting-loadbalancer = neutronclient.neutron.v2_0.agentscheduler:GetLbaasAgentHostingLoadBalancer
lbaas-healthmonitor-create = neutronclient.neutron.v2_0.lb.v2.healthmonitor:CreateHealthMonitor
lbaas-healthmonitor-delete = neutronclient.neutron.v2_0.lb.v2.healthmonitor:DeleteHealthMonitor
lbaas-healthmonitor-list = neutronclient.neutron.v2_0.lb.v2.healthmonitor:ListHealthMonitor
lbaas-healthmonitor-show = neutronclient.neutron.v2_0.lb.v2.healthmonitor:ShowHealthMonitor
lbaas-healthmonitor-update = neutronclient.neutron.v2_0.lb.v2.healthmonitor:UpdateHealthMonitor
lbaas-l7policy-create = neutronclient.neutron.v2_0.lb.v2.l7policy:CreateL7Policy
lbaas-l7policy-delete = neutronclient.neutron.v2_0.lb.v2.l7policy:DeleteL7Policy
lbaas-l7policy-list = neutronclient.neutron.v2_0.lb.v2.l7policy:ListL7Policy
lbaas-l7policy-show = neutronclient.neutron.v2_0.lb.v2.l7policy:ShowL7Policy
lbaas-l7policy-update = neutronclient.neutron.v2_0.lb.v2.l7policy:UpdateL7Policy
lbaas-l7rule-create = neutronclient.neutron.v2_0.lb.v2.l7rule:CreateL7Rule
lbaas-l7rule-delete = neutronclient.neutron.v2_0.lb.v2.l7rule:DeleteL7Rule
lbaas-l7rule-list = neutronclient.neutron.v2_0.lb.v2.l7rule:ListL7Rule
lbaas-l7rule-show = neutronclient.neutron.v2_0.lb.v2.l7rule:ShowL7Rule
lbaas-l7rule-update = neutronclient.neutron.v2_0.lb.v2.l7rule:UpdateL7Rule
lbaas-listener-create = neutronclient.neutron.v2_0.lb.v2.listener:CreateListener
lbaas-listener-delete = neutronclient.neutron.v2_0.lb.v2.listener:DeleteListener
lbaas-listener-list = neutronclient.neutron.v2_0.lb.v2.listener:ListListener
lbaas-listener-show = neutronclient.neutron.v2_0.lb.v2.listener:ShowListener
lbaas-listener-update = neutronclient.neutron.v2_0.lb.v2.listener:UpdateListener
lbaas-loadbalancer-create = neutronclient.neutron.v2_0.lb.v2.loadbalancer:CreateLoadBalancer
lbaas-loadbalancer-delete = neutronclient.neutron.v2_0.lb.v2.loadbalancer:DeleteLoadBalancer
lbaas-loadbalancer-list = neutronclient.neutron.v2_0.lb.v2.loadbalancer:ListLoadBalancer
lbaas-loadbalancer-list-on-agent = neutronclient.neutron.v2_0.agentscheduler:ListLoadBalancersOnLbaasAgent
lbaas-loadbalancer-show = neutronclient.neutron.v2_0.lb.v2.loadbalancer:ShowLoadBalancer
lbaas-loadbalancer-stats = neutronclient.neutron.v2_0.lb.v2.loadbalancer:RetrieveLoadBalancerStats
lbaas-loadbalancer-status = neutronclient.neutron.v2_0.lb.v2.loadbalancer:RetrieveLoadBalancerStatus
lbaas-loadbalancer-update = neutronclient.neutron.v2_0.lb.v2.loadbalancer:UpdateLoadBalancer
lbaas-member-create = neutronclient.neutron.v2_0.lb.v2.member:CreateMember
lbaas-member-delete = neutronclient.neutron.v2_0.lb.v2.member:DeleteMember
lbaas-member-list = neutronclient.neutron.v2_0.lb.v2.member:ListMember
lbaas-member-show = neutronclient.neutron.v2_0.lb.v2.member:ShowMember
lbaas-member-update = neutronclient.neutron.v2_0.lb.v2.member:UpdateMember
lbaas-pool-create = neutronclient.neutron.v2_0.lb.v2.pool:CreatePool
lbaas-pool-delete = neutronclient.neutron.v2_0.lb.v2.pool:DeletePool
lbaas-pool-list = neutronclient.neutron.v2_0.lb.v2.pool:ListPool
lbaas-pool-show = neutronclient.neutron.v2_0.lb.v2.pool:ShowPool
lbaas-pool-update = neutronclient.neutron.v2_0.lb.v2.pool:UpdatePool
meter-label-create = neutronclient.neutron.v2_0.metering:CreateMeteringLabel
meter-label-delete = neutronclient.neutron.v2_0.metering:DeleteMeteringLabel
meter-label-list = neutronclient.neutron.v2_0.metering:ListMeteringLabel
meter-label-rule-create = neutronclient.neutron.v2_0.metering:CreateMeteringLabelRule
meter-label-rule-delete = neutronclient.neutron.v2_0.metering:DeleteMeteringLabelRule
meter-label-rule-list = neutronclient.neutron.v2_0.metering:ListMeteringLabelRule
meter-label-rule-show = neutronclient.neutron.v2_0.metering:ShowMeteringLabelRule
meter-label-show = neutronclient.neutron.v2_0.metering:ShowMeteringLabel
net-create = neutronclient.neutron.v2_0.network:CreateNetwork
net-delete = neutronclient.neutron.v2_0.network:DeleteNetwork
net-external-list = neutronclient.neutron.v2_0.network:ListExternalNetwork
net-ip-availability-list = neutronclient.neutron.v2_0.network_ip_availability:ListIpAvailability
net-ip-availability-show = neutronclient.neutron.v2_0.network_ip_availability:ShowIpAvailability
net-list = neutronclient.neutron.v2_0.network:ListNetwork
net-list-on-dhcp-agent = neutronclient.neutron.v2_0.agentscheduler:ListNetworksOnDhcpAgent
net-show = neutronclient.neutron.v2_0.network:ShowNetwork
net-update = neutronclient.neutron.v2_0.network:UpdateNetwork
port-create = neutronclient.neutron.v2_0.port:CreatePort
port-delete = neutronclient.neutron.v2_0.port:DeletePort
port-list = neutronclient.neutron.v2_0.port:ListPort
port-show = neutronclient.neutron.v2_0.port:ShowPort
port-update = neutronclient.neutron.v2_0.port:UpdatePort
purge = neutronclient.neutron.v2_0.purge:Purge
qos-available-rule-types = neutronclient.neutron.v2_0.qos.rule:ListQoSRuleTypes
qos-bandwidth-limit-rule-create = neutronclient.neutron.v2_0.qos.bandwidth_limit_rule:CreateQoSBandwidthLimitRule
qos-bandwidth-limit-rule-delete = neutronclient.neutron.v2_0.qos.bandwidth_limit_rule:DeleteQoSBandwidthLimitRule
qos-bandwidth-limit-rule-list = neutronclient.neutron.v2_0.qos.bandwidth_limit_rule:ListQoSBandwidthLimitRules
qos-bandwidth-limit-rule-show = neutronclient.neutron.v2_0.qos.bandwidth_limit_rule:ShowQoSBandwidthLimitRule
qos-bandwidth-limit-rule-update = neutronclient.neutron.v2_0.qos.bandwidth_limit_rule:UpdateQoSBandwidthLimitRule
qos-dscp-marking-rule-create = neutronclient.neutron.v2_0.qos.dscp_marking_rule:CreateQoSDscpMarkingRule
qos-dscp-marking-rule-delete = neutronclient.neutron.v2_0.qos.dscp_marking_rule:DeleteQoSDscpMarkingRule
qos-dscp-marking-rule-list = neutronclient.neutron.v2_0.qos.dscp_marking_rule:ListQoSDscpMarkingRules
qos-dscp-marking-rule-show = neutronclient.neutron.v2_0.qos.dscp_marking_rule:ShowQoSDscpMarkingRule
qos-dscp-marking-rule-update = neutronclient.neutron.v2_0.qos.dscp_marking_rule:UpdateQoSDscpMarkingRule
qos-minimum-bandwidth-rule-create = neutronclient.neutron.v2_0.qos.minimum_bandwidth_rule:CreateQoSMinimumBandwidthRule
qos-minimum-bandwidth-rule-delete = neutronclient.neutron.v2_0.qos.minimum_bandwidth_rule:DeleteQoSMinimumBandwidthRule
qos-minimum-bandwidth-rule-list = neutronclient.neutron.v2_0.qos.minimum_bandwidth_rule:ListQoSMinimumBandwidthRules
qos-minimum-bandwidth-rule-show = neutronclient.neutron.v2_0.qos.minimum_bandwidth_rule:ShowQoSMinimumBandwidthRule
qos-minimum-bandwidth-rule-update = neutronclient.neutron.v2_0.qos.minimum_bandwidth_rule:UpdateQoSMinimumBandwidthRule
qos-policy-create = neutronclient.neutron.v2_0.qos.policy:CreateQoSPolicy
qos-policy-delete = neutronclient.neutron.v2_0.qos.policy:DeleteQoSPolicy
qos-policy-list = neutronclient.neutron.v2_0.qos.policy:ListQoSPolicy
qos-policy-show = neutronclient.neutron.v2_0.qos.policy:ShowQoSPolicy
qos-policy-update = neutronclient.neutron.v2_0.qos.policy:UpdateQoSPolicy
quota-default-show = neutronclient.neutron.v2_0.quota:ShowQuotaDefault
quota-delete = neutronclient.neutron.v2_0.quota:DeleteQuota
quota-list = neutronclient.neutron.v2_0.quota:ListQuota
quota-show = neutronclient.neutron.v2_0.quota:ShowQuota
quota-update = neutronclient.neutron.v2_0.quota:UpdateQuota
rbac-create = neutronclient.neutron.v2_0.rbac:CreateRBACPolicy
rbac-delete = neutronclient.neutron.v2_0.rbac:DeleteRBACPolicy
rbac-list = neutronclient.neutron.v2_0.rbac:ListRBACPolicy
rbac-show = neutronclient.neutron.v2_0.rbac:ShowRBACPolicy
rbac-update = neutronclient.neutron.v2_0.rbac:UpdateRBACPolicy
router-create = neutronclient.neutron.v2_0.router:CreateRouter
router-delete = neutronclient.neutron.v2_0.router:DeleteRouter
router-gateway-clear = neutronclient.neutron.v2_0.router:RemoveGatewayRouter
router-gateway-set = neutronclient.neutron.v2_0.router:SetGatewayRouter
router-interface-add = neutronclient.neutron.v2_0.router:AddInterfaceRouter
router-interface-delete = neutronclient.neutron.v2_0.router:RemoveInterfaceRouter
router-list = neutronclient.neutron.v2_0.router:ListRouter
router-list-on-l3-agent = neutronclient.neutron.v2_0.agentscheduler:ListRoutersOnL3Agent
router-port-list = neutronclient.neutron.v2_0.port:ListRouterPort
router-show = neutronclient.neutron.v2_0.router:ShowRouter
router-update = neutronclient.neutron.v2_0.router:UpdateRouter
security-group-create = neutronclient.neutron.v2_0.securitygroup:CreateSecurityGroup
security-group-delete = neutronclient.neutron.v2_0.securitygroup:DeleteSecurityGroup
security-group-list = neutronclient.neutron.v2_0.securitygroup:ListSecurityGroup
security-group-rule-create = neutronclient.neutron.v2_0.securitygroup:CreateSecurityGroupRule
security-group-rule-delete = neutronclient.neutron.v2_0.securitygroup:DeleteSecurityGroupRule
security-group-rule-list = neutronclient.neutron.v2_0.securitygroup:ListSecurityGroupRule
security-group-rule-show = neutronclient.neutron.v2_0.securitygroup:ShowSecurityGroupRule
security-group-show = neutronclient.neutron.v2_0.securitygroup:ShowSecurityGroup
security-group-update = neutronclient.neutron.v2_0.securitygroup:UpdateSecurityGroup
service-provider-list = neutronclient.neutron.v2_0.servicetype:ListServiceProvider
subnet-create = neutronclient.neutron.v2_0.subnet:CreateSubnet
subnet-delete = neutronclient.neutron.v2_0.subnet:DeleteSubnet
subnet-list = neutronclient.neutron.v2_0.subnet:ListSubnet
subnet-show = neutronclient.neutron.v2_0.subnet:ShowSubnet
subnet-update = neutronclient.neutron.v2_0.subnet:UpdateSubnet
subnetpool-create = neutronclient.neutron.v2_0.subnetpool:CreateSubnetPool
subnetpool-delete = neutronclient.neutron.v2_0.subnetpool:DeleteSubnetPool
subnetpool-list = neutronclient.neutron.v2_0.subnetpool:ListSubnetPool
subnetpool-show = neutronclient.neutron.v2_0.subnetpool:ShowSubnetPool
subnetpool-update = neutronclient.neutron.v2_0.subnetpool:UpdateSubnetPool
tag-add = neutronclient.neutron.v2_0.tag:AddTag
tag-remove = neutronclient.neutron.v2_0.tag:RemoveTag
tag-replace = neutronclient.neutron.v2_0.tag:ReplaceTag
vpn-endpoint-group-create = neutronclient.neutron.v2_0.vpn.endpoint_group:CreateEndpointGroup
vpn-endpoint-group-delete = neutronclient.neutron.v2_0.vpn.endpoint_group:DeleteEndpointGroup
vpn-endpoint-group-list = neutronclient.neutron.v2_0.vpn.endpoint_group:ListEndpointGroup
vpn-endpoint-group-show = neutronclient.neutron.v2_0.vpn.endpoint_group:ShowEndpointGroup
vpn-endpoint-group-update = neutronclient.neutron.v2_0.vpn.endpoint_group:UpdateEndpointGroup
vpn-ikepolicy-create = neutronclient.neutron.v2_0.vpn.ikepolicy:CreateIKEPolicy
vpn-ikepolicy-delete = neutronclient.neutron.v2_0.vpn.ikepolicy:DeleteIKEPolicy
vpn-ikepolicy-list = neutronclient.neutron.v2_0.vpn.ikepolicy:ListIKEPolicy
vpn-ikepolicy-show = neutronclient.neutron.v2_0.vpn.ikepolicy:ShowIKEPolicy
vpn-ikepolicy-update = neutronclient.neutron.v2_0.vpn.ikepolicy:UpdateIKEPolicy
vpn-ipsecpolicy-create = neutronclient.neutron.v2_0.vpn.ipsecpolicy:CreateIPsecPolicy
vpn-ipsecpolicy-delete = neutronclient.neutron.v2_0.vpn.ipsecpolicy:DeleteIPsecPolicy
vpn-ipsecpolicy-list = neutronclient.neutron.v2_0.vpn.ipsecpolicy:ListIPsecPolicy
vpn-ipsecpolicy-show = neutronclient.neutron.v2_0.vpn.ipsecpolicy:ShowIPsecPolicy
vpn-ipsecpolicy-update = neutronclient.neutron.v2_0.vpn.ipsecpolicy:UpdateIPsecPolicy
vpn-service-create = neutronclient.neutron.v2_0.vpn.vpnservice:CreateVPNService
vpn-service-delete = neutronclient.neutron.v2_0.vpn.vpnservice:DeleteVPNService
vpn-service-list = neutronclient.neutron.v2_0.vpn.vpnservice:ListVPNService
vpn-service-show = neutronclient.neutron.v2_0.vpn.vpnservice:ShowVPNService
vpn-service-update = neutronclient.neutron.v2_0.vpn.vpnservice:UpdateVPNService

[openstack.cli.extension]
neutronclient = neutronclient.osc.plugin

[openstack.neutronclient.v2]
bgp_dragent_add_speaker = neutronclient.osc.v2.dynamic_routing.bgp_dragent:AddBgpSpeakerToDRAgent
bgp_dragent_remove_speaker = neutronclient.osc.v2.dynamic_routing.bgp_dragent:RemoveBgpSpeakerFromDRAgent
bgp_peer_create = neutronclient.osc.v2.dynamic_routing.bgp_peer:CreateBgpPeer
bgp_peer_delete = neutronclient.osc.v2.dynamic_routing.bgp_peer:DeleteBgpPeer
bgp_peer_list = neutronclient.osc.v2.dynamic_routing.bgp_peer:ListBgpPeer
bgp_peer_set = neutronclient.osc.v2.dynamic_routing.bgp_peer:SetBgpPeer
bgp_peer_show = neutronclient.osc.v2.dynamic_routing.bgp_peer:ShowBgpPeer
bgp_speaker_add_network = neutronclient.osc.v2.dynamic_routing.bgp_speaker:AddNetworkToSpeaker
bgp_speaker_add_peer = neutronclient.osc.v2.dynamic_routing.bgp_speaker:AddPeerToSpeaker
bgp_speaker_create = neutronclient.osc.v2.dynamic_routing.bgp_speaker:CreateBgpSpeaker
bgp_speaker_delete = neutronclient.osc.v2.dynamic_routing.bgp_speaker:DeleteBgpSpeaker
bgp_speaker_list = neutronclient.osc.v2.dynamic_routing.bgp_speaker:ListBgpSpeaker
bgp_speaker_list_advertised_routes = neutronclient.osc.v2.dynamic_routing.bgp_speaker:ListRoutesAdvertisedBySpeaker
bgp_speaker_remove_network = neutronclient.osc.v2.dynamic_routing.bgp_speaker:RemoveNetworkFromSpeaker
bgp_speaker_remove_peer = neutronclient.osc.v2.dynamic_routing.bgp_speaker:RemovePeerFromSpeaker
bgp_speaker_set = neutronclient.osc.v2.dynamic_routing.bgp_speaker:SetBgpSpeaker
bgp_speaker_show = neutronclient.osc.v2.dynamic_routing.bgp_speaker:ShowBgpSpeaker
bgp_speaker_show_dragents = neutronclient.osc.v2.dynamic_routing.bgp_dragent:ListDRAgentsHostingBgpSpeaker
bgpvpn_create = neutronclient.osc.v2.networking_bgpvpn.bgpvpn:CreateBgpvpn
bgpvpn_delete = neutronclient.osc.v2.networking_bgpvpn.bgpvpn:DeleteBgpvpn
bgpvpn_list = neutronclient.osc.v2.networking_bgpvpn.bgpvpn:ListBgpvpn
bgpvpn_network_association_create = neutronclient.osc.v2.networking_bgpvpn.network_association:CreateBgpvpnNetAssoc
bgpvpn_network_association_delete = neutronclient.osc.v2.networking_bgpvpn.network_association:DeleteBgpvpnNetAssoc
bgpvpn_network_association_list = neutronclient.osc.v2.networking_bgpvpn.network_association:ListBgpvpnNetAssoc
bgpvpn_network_association_show = neutronclient.osc.v2.networking_bgpvpn.network_association:ShowBgpvpnNetAssoc
bgpvpn_port_association_create = neutronclient.osc.v2.networking_bgpvpn.port_association:CreateBgpvpnPortAssoc
bgpvpn_port_association_delete = neutronclient.osc.v2.networking_bgpvpn.port_association:DeleteBgpvpnPortAssoc
bgpvpn_port_association_list = neutronclient.osc.v2.networking_bgpvpn.port_association:ListBgpvpnPortAssoc
bgpvpn_port_association_set = neutronclient.osc.v2.networking_bgpvpn.port_association:SetBgpvpnPortAssoc
bgpvpn_port_association_show = neutronclient.osc.v2.networking_bgpvpn.port_association:ShowBgpvpnPortAssoc
bgpvpn_port_association_unset = neutronclient.osc.v2.networking_bgpvpn.port_association:UnsetBgpvpnPortAssoc
bgpvpn_router_association_create = neutronclient.osc.v2.networking_bgpvpn.router_association:CreateBgpvpnRouterAssoc
bgpvpn_router_association_delete = neutronclient.osc.v2.networking_bgpvpn.router_association:DeleteBgpvpnRouterAssoc
bgpvpn_router_association_list = neutronclient.osc.v2.networking_bgpvpn.router_association:ListBgpvpnRouterAssoc
bgpvpn_router_association_set = neutronclient.osc.v2.networking_bgpvpn.router_association:SetBgpvpnRouterAssoc
bgpvpn_router_association_show = neutronclient.osc.v2.networking_bgpvpn.router_association:ShowBgpvpnRouterAssoc
bgpvpn_router_association_unset = neutronclient.osc.v2.networking_bgpvpn.router_association:UnsetBgpvpnRouterAssoc
bgpvpn_set = neutronclient.osc.v2.networking_bgpvpn.bgpvpn:SetBgpvpn
bgpvpn_show = neutronclient.osc.v2.networking_bgpvpn.bgpvpn:ShowBgpvpn
bgpvpn_unset = neutronclient.osc.v2.networking_bgpvpn.bgpvpn:UnsetBgpvpn
firewall_group_create = neutronclient.osc.v2.fwaas.firewallgroup:CreateFirewallGroup
firewall_group_delete = neutronclient.osc.v2.fwaas.firewallgroup:DeleteFirewallGroup
firewall_group_list = neutronclient.osc.v2.fwaas.firewallgroup:ListFirewallGroup
firewall_group_policy_add_rule = neutronclient.osc.v2.fwaas.firewallpolicy:FirewallPolicyInsertRule
firewall_group_policy_create = neutronclient.osc.v2.fwaas.firewallpolicy:CreateFirewallPolicy
firewall_group_policy_delete = neutronclient.osc.v2.fwaas.firewallpolicy:DeleteFirewallPolicy
firewall_group_policy_list = neutronclient.osc.v2.fwaas.firewallpolicy:ListFirewallPolicy
firewall_group_policy_remove_rule = neutronclient.osc.v2.fwaas.firewallpolicy:FirewallPolicyRemoveRule
firewall_group_policy_set = neutronclient.osc.v2.fwaas.firewallpolicy:SetFirewallPolicy
firewall_group_policy_show = neutronclient.osc.v2.fwaas.firewallpolicy:ShowFirewallPolicy
firewall_group_policy_unset = neutronclient.osc.v2.fwaas.firewallpolicy:UnsetFirewallPolicy
firewall_group_rule_create = neutronclient.osc.v2.fwaas.firewallrule:CreateFirewallRule
firewall_group_rule_delete = neutronclient.osc.v2.fwaas.firewallrule:DeleteFirewallRule
firewall_group_rule_list = neutronclient.osc.v2.fwaas.firewallrule:ListFirewallRule
firewall_group_rule_set = neutronclient.osc.v2.fwaas.firewallrule:SetFirewallRule
firewall_group_rule_show = neutronclient.osc.v2.fwaas.firewallrule:ShowFirewallRule
firewall_group_rule_unset = neutronclient.osc.v2.fwaas.firewallrule:UnsetFirewallRule
firewall_group_set = neutronclient.osc.v2.fwaas.firewallgroup:SetFirewallGroup
firewall_group_show = neutronclient.osc.v2.fwaas.firewallgroup:ShowFirewallGroup
firewall_group_unset = neutronclient.osc.v2.fwaas.firewallgroup:UnsetFirewallGroup
network_log_create = neutronclient.osc.v2.logging.network_log:CreateNetworkLog
network_log_delete = neutronclient.osc.v2.logging.network_log:DeleteNetworkLog
network_log_list = neutronclient.osc.v2.logging.network_log:ListNetworkLog
network_log_set = neutronclient.osc.v2.logging.network_log:SetNetworkLog
network_log_show = neutronclient.osc.v2.logging.network_log:ShowNetworkLog
network_loggable_resources_list = neutronclient.osc.v2.logging.network_log:ListLoggableResource
network_onboard_subnets = neutronclient.osc.v2.subnet_onboard.subnet_onboard:NetworkOnboardSubnets
network_subport_list = neutronclient.osc.v2.trunk.network_trunk:ListNetworkSubport
network_trunk_create = neutronclient.osc.v2.trunk.network_trunk:CreateNetworkTrunk
network_trunk_delete = neutronclient.osc.v2.trunk.network_trunk:DeleteNetworkTrunk
network_trunk_list = neutronclient.osc.v2.trunk.network_trunk:ListNetworkTrunk
network_trunk_set = neutronclient.osc.v2.trunk.network_trunk:SetNetworkTrunk
network_trunk_show = neutronclient.osc.v2.trunk.network_trunk:ShowNetworkTrunk
network_trunk_unset = neutronclient.osc.v2.trunk.network_trunk:UnsetNetworkTrunk
sfc_flow_classifier_create = neutronclient.osc.v2.sfc.sfc_flow_classifier:CreateSfcFlowClassifier
sfc_flow_classifier_delete = neutronclient.osc.v2.sfc.sfc_flow_classifier:DeleteSfcFlowClassifier
sfc_flow_classifier_list = neutronclient.osc.v2.sfc.sfc_flow_classifier:ListSfcFlowClassifier
sfc_flow_classifier_set = neutronclient.osc.v2.sfc.sfc_flow_classifier:SetSfcFlowClassifier
sfc_flow_classifier_show = neutronclient.osc.v2.sfc.sfc_flow_classifier:ShowSfcFlowClassifier
sfc_port_chain_create = neutronclient.osc.v2.sfc.sfc_port_chain:CreateSfcPortChain
sfc_port_chain_delete = neutronclient.osc.v2.sfc.sfc_port_chain:DeleteSfcPortChain
sfc_port_chain_list = neutronclient.osc.v2.sfc.sfc_port_chain:ListSfcPortChain
sfc_port_chain_set = neutronclient.osc.v2.sfc.sfc_port_chain:SetSfcPortChain
sfc_port_chain_show = neutronclient.osc.v2.sfc.sfc_port_chain:ShowSfcPortChain
sfc_port_chain_unset = neutronclient.osc.v2.sfc.sfc_port_chain:UnsetSfcPortChain
sfc_port_pair_create = neutronclient.osc.v2.sfc.sfc_port_pair:CreateSfcPortPair
sfc_port_pair_delete = neutronclient.osc.v2.sfc.sfc_port_pair:DeleteSfcPortPair
sfc_port_pair_group_create = neutronclient.osc.v2.sfc.sfc_port_pair_group:CreateSfcPortPairGroup
sfc_port_pair_group_delete = neutronclient.osc.v2.sfc.sfc_port_pair_group:DeleteSfcPortPairGroup
sfc_port_pair_group_list = neutronclient.osc.v2.sfc.sfc_port_pair_group:ListSfcPortPairGroup
sfc_port_pair_group_set = neutronclient.osc.v2.sfc.sfc_port_pair_group:SetSfcPortPairGroup
sfc_port_pair_group_show = neutronclient.osc.v2.sfc.sfc_port_pair_group:ShowSfcPortPairGroup
sfc_port_pair_group_unset = neutronclient.osc.v2.sfc.sfc_port_pair_group:UnsetSfcPortPairGroup
sfc_port_pair_list = neutronclient.osc.v2.sfc.sfc_port_pair:ListSfcPortPair
sfc_port_pair_set = neutronclient.osc.v2.sfc.sfc_port_pair:SetSfcPortPair
sfc_port_pair_show = neutronclient.osc.v2.sfc.sfc_port_pair:ShowSfcPortPair
sfc_service_graph_create = neutronclient.osc.v2.sfc.sfc_service_graph:CreateSfcServiceGraph
sfc_service_graph_delete = neutronclient.osc.v2.sfc.sfc_service_graph:DeleteSfcServiceGraph
sfc_service_graph_list = neutronclient.osc.v2.sfc.sfc_service_graph:ListSfcServiceGraph
sfc_service_graph_set = neutronclient.osc.v2.sfc.sfc_service_graph:SetSfcServiceGraph
sfc_service_graph_show = neutronclient.osc.v2.sfc.sfc_service_graph:ShowSfcServiceGraph
vpn_endpoint_group_create = neutronclient.osc.v2.vpnaas.endpoint_group:CreateEndpointGroup
vpn_endpoint_group_delete = neutronclient.osc.v2.vpnaas.endpoint_group:DeleteEndpointGroup
vpn_endpoint_group_list = neutronclient.osc.v2.vpnaas.endpoint_group:ListEndpointGroup
vpn_endpoint_group_set = neutronclient.osc.v2.vpnaas.endpoint_group:SetEndpointGroup
vpn_endpoint_group_show = neutronclient.osc.v2.vpnaas.endpoint_group:ShowEndpointGroup
vpn_ike_policy_create = neutronclient.osc.v2.vpnaas.ikepolicy:CreateIKEPolicy
vpn_ike_policy_delete = neutronclient.osc.v2.vpnaas.ikepolicy:DeleteIKEPolicy
vpn_ike_policy_list = neutronclient.osc.v2.vpnaas.ikepolicy:ListIKEPolicy
vpn_ike_policy_set = neutronclient.osc.v2.vpnaas.ikepolicy:SetIKEPolicy
vpn_ike_policy_show = neutronclient.osc.v2.vpnaas.ikepolicy:ShowIKEPolicy
vpn_ipsec_policy_create = neutronclient.osc.v2.vpnaas.ipsecpolicy:CreateIPsecPolicy
vpn_ipsec_policy_delete = neutronclient.osc.v2.vpnaas.ipsecpolicy:DeleteIPsecPolicy
vpn_ipsec_policy_list = neutronclient.osc.v2.vpnaas.ipsecpolicy:ListIPsecPolicy
vpn_ipsec_policy_set = neutronclient.osc.v2.vpnaas.ipsecpolicy:SetIPsecPolicy
vpn_ipsec_policy_show = neutronclient.osc.v2.vpnaas.ipsecpolicy:ShowIPsecPolicy
vpn_ipsec_site_connection_create = neutronclient.osc.v2.vpnaas.ipsec_site_connection:CreateIPsecSiteConnection
vpn_ipsec_site_connection_delete = neutronclient.osc.v2.vpnaas.ipsec_site_connection:DeleteIPsecSiteConnection
vpn_ipsec_site_connection_list = neutronclient.osc.v2.vpnaas.ipsec_site_connection:ListIPsecSiteConnection
vpn_ipsec_site_connection_set = neutronclient.osc.v2.vpnaas.ipsec_site_connection:SetIPsecSiteConnection
vpn_ipsec_site_connection_show = neutronclient.osc.v2.vpnaas.ipsec_site_connection:ShowIPsecSiteConnection
vpn_service_create = neutronclient.osc.v2.vpnaas.vpnservice:CreateVPNService
vpn_service_delete = neutronclient.osc.v2.vpnaas.vpnservice:DeleteVPNService
vpn_service_list = neutronclient.osc.v2.vpnaas.vpnservice:ListVPNService
vpn_service_set = neutronclient.osc.v2.vpnaas.vpnservice:SetVPNSercice
vpn_service_show = neutronclient.osc.v2.vpnaas.vpnservice:ShowVPNService

